{"map": 
   ["##############################",
    "|                            |",
    "|   =                        |",
    "|                            |",
    "|                   =        |",
    "|  _------_                  |",
    "|                            |",
    "|                            |",
    "|        _----_        =     |",
    "|                            |",
    "|            |               |",
    "|                            |",
    "|                            |",
    "|  =                         |",
    "|       _--_                 |",
    "|                            |",
    "|                     _--_   |",
    "|                            |",
    "##############################"]}